XXXXX
X   X
X R X
X   X
XH *X
XXXXX