XXXXX
XD  X
X R XXXXXX
X   XX   X
XH T    TX
XX XXXXXXX
X   X
XT  X
XXXXX