XXXXX
XD  X
X R XXXXXX
XK  XXK  X
XH T    TX
XXBXXXXXXX
X   X
XT  X
XXXXX