XXXXXXXXXXXXXXXX
XD             X
X R      XXXXXXX
XK  XXK  X
XH T    TX
XXBXXXXXXX
X   X
XT  X
XXXXX